1111111111111111111
1P000000000000000E1
1111111111111111111
1101110101000100011
1101110101011101011
1101110101011100011
1101110101011101011
1100010001000101011
1111111111111111111
1CCCCCCCCCCCCCCCCC1
1111111111111111111