111111111111111111111111
1E00000000000000000000C1
111111111111111111111101
1C000000000000000000C101
101111111111111111110101
101C00000000000000C10101
101011111111111111010101
10101C0000000000C1010101
101010111111111101010101
1010101C000000C101010101
101010101111110101010101
101010101C00C10101010101
101010101011010101010101
10101010101PC10101010101
101010101011110101010101
101010101C0000C101010101
101010101111111101010101
1010101C00000000C1010101
101010111111111111010101
10101C000000000000C10101
101011111111111111110101
101C0000000000000000C101
101111111111111111111101
1C00000000000000000000C1
111111111111111111111111